10 10
##########
#P########
#        #
# ###### #
# ##     #
# ## #####
# ##     #
# ###### #
#  T     #
##########